###.#.#####....##..##..##.
..........#.....#.........
#.....#..............#...#
.....#....#...#...........
#..#.....................#
#.....#.....@.......#....#
#....#....................
..........#...............
....#...........#........#
#.....#..................#
....#...##..##...###.###..